{
    "Actors": {

    },
    "Tiles": [
        { "pos": [0, 1], "tPos": [2, 0] },
        { "pos": [1, 1], "tPos": [3, 0] },
        { "pos": [0, 2], "tPos": [2, 1] },
        { "pos": [1, 2], "tPos": [3, 1] }
    ],
    "Ground": [
        { "pos": [0, 0], "tPos": [0, 0] },
        { "pos": [1, 0], "tPos": [0, 0] },
        { "pos": [2, 0], "tPos": [0, 0] },
        { "pos": [0, 1], "tPos": [0, 0] },
        { "pos": [1, 1], "tPos": [0, 0] },
        { "pos": [2, 1], "tPos": [5, 3] },
        { "pos": [0, 2], "tPos": [0, 0] },
        { "pos": [1, 2], "tPos": [0, 0] },
        { "pos": [2, 2], "tPos": [0, 0] }
    ]
}
